1111111111111
1CX10000000C1
1000011111X01
1P0X11E000001
1111111111111
