1111111111111111111111111111111111
1E00000X0000000C00000C000000000001
101X01010010000010100100X000010101
101001001010101000100100000001X101
100000000C00C0000000000000000000C1
101111111C100011000011111111111111
101111111C100011X00X11111111111111
1P1111111C1XXX110XX011111111111111
1111111111111111111111111111111111
