1111111111111111111111111111111111
1E0000000000000C00000C000000000001
1010010100100000101001000000010101
1010010010101010001001000000010101
100000000C00C0000000000000000000C1
101111111C100011000011111111111111
101111111C100011000011111111111111
1P1111111C100011000011111111111111
1111111111111111111111111111111111
