111111111
1E0000001
100111PC1
111111111
