1111111111111
1C010000000C1
10000111110011
1P0011E0000011
1111111111111
